111111111111111111111
100243202402432024001
101010101010101010101
120202020202020202021
101010101010101010101
124340240240240243421
101010101010101010101
120202020202020202021
101010101010101010101
120404040404040404021
101010101010101010101
124302430243024302421
101010101010101010101
120202020202020202021
100243202402432024001
101010101010101010101
111111111111111111111
