111111111111111111111
100202020202020202001
101010101010101010101
120202020202020202021
101010101010101010101
120202020202020202021
101010101010101010101
120202020202020202021
101010101010101010101
120202020202020202021
101010101010101010101
120202020202020202021
101010101010101010101
120202020202020202021
101010101010101010101
100202020202020202001
111111111111111111111

