002020202020202020202020202020
010101010101010101010101010101
202020202020202020202020202020
010101010101010101010101010101
202020202020202020202020202020
010101010101010101010101010101
202020202020202020202020202020
010101010101010101010101010101
202020202020202020202020202020
010101010101010101010101010101
202020202020202020202020202020
010101010101010101010101010101
202020202020202020202020202020
010101010101010101010101010101
202020202020202020202020202020
002020202020202020202020202020