202020202020202020202020202020
010101010101010101010101010101
202000202020202020202020002020
010101010101010101010101010101
202020202000202000202000202020
010101010101010101010101010101
002020202020002020202020202000
010101010101010101010101010101
202020002020202020202000202020
010101010101010101010101010101
202000202000202020200020002020
010101010101010101010101010101
202020202020002000202020202020
010101010101010101010101010101
002000202020202020202020002000
202020202020202020202020202020
