111111111111111111111
100200000000000002001
101210101010101012101
120202020202020202021
101010101010101010101
120000000000000000021
101010101010101010101
120000000300000000021
101010101010101010101
120000000000000000021
101010101010101010101
120202020202020202021
101210101010101012101
100200000000000002001
101010101010101010101
100202020202020202001
111111111111111111111
