111111111111111111111
100000000000000000001
101010101010101010101
100000000202000000001
101010101010101010101
100000000202000000001
101010101010101010101
100000000202000000001
101010101010101010101
100000000202000000001
101010101010101010101
100000000202000000001
101010101010101010101
100000000000000000001
101010101010101010101
100202020202020202001
111111111111111111111
