01012121010101210101210121
00222220000200022222002200
01012101012121010121012101
20222002222220020000002222
21012101012101010101212101
02200002202222200200202022
01010121012101210121212101
22222000022020022200220000
01012121212121010101210121
00202220202020000222200020
01210121012121010101210121
22200020200002222200202220
01210101010101010101210121
20222200202222002002202200
01010101210101012121212101