111111111111111111111
100202020101020202001
101010101212101010101
120202020101020202021
101010101212101010101
120202020101020202021
101010101212101010101
120202020101020202021
101010101212101010101
120202020101020202021
101010101212101010101
120202020101020202021
101010101212101010101
120202020101020202021
101010101212101010101
100202020101020202001
111111111111111111111
